[
	{
		"tiles": []
	},
	{
		"tiles": [
			1, 1, 1, 1, 1, 1, 1, 1,
			1, 1, 1, 1, 1, 1, 1, 1,
			1, 1, 1, 1, 1, 1, 1, 1,
			1, 1, 1, 1, 1, 1, 1, 1,
			1, 1, 1, 1, 1, 1, 1, 1,
			1, 1, 1, 1, 1, 1, 1, 1,
			1, 1, 1, 1, 1, 1, 1, 1,
			1, 1, 1, 1, 1, 1, 1, 1
		]
	},
	{
		"tiles": [
			2, 3, 0, 0, 0, 0, 0, 0,
			4, 5, 1, 1, 1, 1, 1, 1,
			0, 0, 1, 1, 0, 0, 1, 1,
			0, 0, 1, 0, 0, 0, 0, 1,
			0, 0, 0, 0, 0, 0, 0, 0,
			0, 0, 0, 0, 0, 0, 0, 0,
			0, 0, 0, 0, 0, 0, 0, 0,
			0, 0, 0, 0, 0, 0, 0, 0
		]
	},
	{
		"tiles": [
			0, 0, 0, 0, 0, 0, 0, 0,
			1, 1, 1, 1, 1, 1, 1, 1,
			1, 1, 1, 1, 1, 1, 1, 1,
			1, 1, 1, 1, 1, 1, 1, 1,
			1, 1, 1, 1, 1, 1, 1, 1,
			0, 0, 0, 0, 0, 0, 0, 0,
			0, 0, 0, 0, 0, 0, 0, 0,
			0, 0, 0, 0, 0, 0, 0, 0
		]
	}
]
